1;1;1;1;1;1;1;1;1;1;1;1;1;1;1;
1;0;0;0;0;0;0;1;0;0;0;0;0;0;1;
1;0;3;0;0;0;0;1;0;0;0;0;0;0;1;
1;0;0;0;0;0;0;1;0;0;0;0;3;0;1;
1;0;0;0;1;1;1;1;1;1;1;0;0;0;1;
1;0;0;0;1;4;4;4;4;4;1;0;0;0;1;
1;0;0;0;1;4;4;4;4;4;1;0;0;0;1;
1;0;0;0;1;4;4;4;4;4;1;0;0;0;1;
1;0;0;0;1;0;0;0;0;0;1;0;0;0;1;
1;0;0;0;0;0;0;0;0;0;0;0;0;0;1;
1;0;0;0;0;0;0;0;0;0;0;0;1;1;1;
1;0;0;0;0;0;0;1;0;0;0;0;7;0;9;
1;0;2;0;0;0;0;0;0;0;0;0;1;1;1;
1;0;0;0;1;0;0;0;0;0;0;0;0;0;1;
1;1;1;1;1;1;1;1;1;1;1;1;1;1;1;
