1;1;1;1;1;1;1;1;1;1;1;1;1;1;1;
1;0;0;0;0;0;0;9;0;0;0;0;0;0;1;
1;0;0;0;0;0;0;0;0;0;0;0;0;0;1;
1;0;0;0;0;0;0;0;0;0;0;0;0;0;1;
1;0;0;0;1;1;1;1;1;1;1;0;0;0;1;
1;0;0;0;1;4;4;4;4;4;1;0;0;0;1;
1;0;0;0;1;4;4;4;4;4;1;0;0;0;1;
1;0;0;0;1;4;4;4;4;4;1;0;0;0;1;
1;0;0;0;1;1;1;1;1;1;1;0;0;0;1;
1;0;0;0;0;0;0;0;0;0;0;0;0;0;1;
1;0;0;0;0;0;0;0;0;0;0;0;0;0;1;
1;0;0;0;0;0;0;2;0;0;0;0;0;0;1;
1;0;0;0;0;0;0;0;0;0;0;0;0;0;1;
1;0;0;0;0;0;0;0;0;0;0;0;0;0;1;
1;1;1;1;1;1;1;1;1;1;1;1;1;1;1;
