1;1;1;1;1;1;1;1;1;1;1;1;1;1;1;
1;0;0;0;0;0;0;0;0;0;0;9;0;0;1;
1;0;0;0;0;0;0;0;0;0;0;7;0;0;1;
1;0;0;0;0;0;0;0;0;0;0;0;0;0;1;
1;0;0;0;0;0;0;0;0;0;0;0;0;0;1;
1;0;0;0;0;1;1;1;1;1;0;0;0;0;1;
1;0;0;0;0;1;1;31;1;1;0;0;0;0;1;
1;0;0;0;0;0;0;0;0;0;0;0;0;0;1;
1;0;0;0;0;0;0;0;0;0;0;0;0;0;1;
1;0;0;0;0;0;0;0;0;0;0;0;0;0;1;
1;1;1;0;1;1;1;1;1;1;1;1;1;1;1;
1;1;1;0;1;1;1;1;1;1;1;1;1;1;1;
1;1;1;2;1;1;1;1;1;1;1;1;1;1;1;
1;1;1;8;1;1;1;1;1;1;1;1;1;1;1;
1;1;1;1;1;1;1;1;1;1;1;1;1;1;1;