14;1;1;1;1;1;1;1;1;1;1;9;1;1;1;
1;0;0;0;0;0;0;0;0;0;0;0;0;0;1;
1;0;0;0;0;0;0;0;0;0;0;7;0;0;1;
1;0;0;0;154;0;0;0;0;0;153;0;0;0;1;
1;0;0;0;0;16;1;1;1;16;0;0;0;0;1;
1;0;0;0;0;1;0;0;0;1;0;0;0;0;1;
1;0;0;0;0;1;0;0;0;1;0;0;0;0;1;
1;0;0;0;0;1;0;13;0;1;0;0;0;0;1;
1;0;0;0;0;16;1;1;1;16;0;0;0;0;1;
1;0;0;0;151;0;0;0;0;0;152;0;0;0;1;
1;0;0;0;0;0;0;0;0;0;0;0;0;0;1;
1;0;0;0;0;0;0;0;0;0;0;0;0;0;1;
1;0;0;2;0;0;0;0;0;0;0;0;0;0;1;
1;0;0;8;0;0;0;0;0;0;0;0;0;0;1;
1;1;1;1;1;1;1;1;1;1;1;1;1;1;1;