1;1;1;1;1;1;1;1;1;1;1;1;1;1;1;
1;0;0;0;0;0;0;0;0;0;0;0;0;0;1;
1;0;0;0;0;0;0;33;0;0;0;0;0;0;1;
1;0;0;0;0;0;0;0;0;0;0;0;0;0;1;
1;11;11;11;11;11;11;11;11;11;11;11;11;11;11;
1;0;0;0;0;0;0;0;0;0;0;0;0;0;1;
1;0;0;0;0;0;0;0;0;1;0;0;0;0;1;
1;0;0;1;0;0;0;0;0;0;0;0;0;0;1;
1;0;0;0;0;0;0;0;0;0;0;0;0;0;1;
1;0;0;0;0;1;0;0;0;0;0;0;0;0;1;
1;99;99;99;99;99;99;0;99;99;99;99;99;99;1;
1;99;99;99;99;99;99;0;99;99;99;99;99;99;1;
1;99;99;99;99;99;99;0;99;99;99;99;99;99;1;
1;99;99;99;99;99;99;2;99;99;99;99;99;99;1;
1;1;1;1;1;1;1;1;1;1;1;1;1;1;1;