1;1;1;1;1;1;9;1;92;1;1;1;1;1;1;
1;0;0;0;0;0;0;1;0;0;0;0;0;0;1;
1;0;1;1;1;1;1;1;1;1;1;1;1;0;1;
1;0;0;0;0;0;0;1;0;0;0;0;0;0;1;
1;1;1;1;0;1;1;1;1;1;0;1;1;1;1;
1;0;0;1;0;0;0;1;0;0;0;1;0;0;1;
1;0;0;0;1;1;0;1;0;1;1;0;0;0;1;
1;0;1;0;0;0;0;1;0;0;0;0;1;0;1;
1;0;1;1;1;1;1;1;1;1;1;1;1;0;1;
1;0;0;0;0;0;0;1;0;0;0;0;0;0;1;
1;1;1;1;1;1;0;1;0;1;1;1;1;1;1;
1;2;0;0;0;1;0;1;0;1;0;0;0;22;1;
1;1;1;1;0;0;0;1;0;0;0;1;1;1;1;
1;8;0;0;0;1;0;1;0;1;0;0;0;82;1;
1;1;1;1;1;1;1;1;1;1;1;1;1;1;1;